█  █      █ █ █   █ █    █   █   █ ██    █  ██         █  █  █   █    █  █   █  
██             █   ██  █ █ ███       █ █  ██    ██   █       █     █ █ ██       
█  ███ ███  ███   ██ █ ██    ██  ███ █ █         ███       █ █  █ ██ ███ █ █ █ █
    █        █     ███  █  █      ██ ██ █     █   █  █    █   █  ██ █    █    ██
  █ █       ██ ██████     ███  ██ █ █     █          █     █            █   █ █ 
   █   ██ ██ ██  █    █ █      ███ █ █      █ █         █  █ █  █    █ ██   █   
   █  █           █   █   █   ██   █  █     █   ██   ██ █   ██ █   █  █ █   ████
      ███ ██        ██     █  █  █ █     █    █      █   █  █ ██  █    █ █ █    
     █   █  █   █ █    I ██   ██        █ █ █ █       ███     █     █  █        
 ██  █  ██  █ ██     ██+  █  █    █  ██     █      █      █ ██   ███  ██ █    █ 
██  ██ █     █ █  █    +      █    ████ ██  ██     █       █ █   ████    █    █ 
  █   ██   ██████   ███+ █    █  █  █ █   ███       █ █ █ █   ███ █     ██ ████ 
    █  ██ █  ██  █ █  █+  ███     █  █  █   ███ █  █  █ █  █ █    █ █       █   
 █  █ █  █        █ █ █+ +++ █  █       ██    ████     ███ ██  ██     █    █   █
█        █     █  █  ██+++█+         █   █   █ █ █ █ ███  ██  █  █     ████  ██ 
    ██      █ ██     █  █ █+ █  ███  ██   █      ██   ██   █  █ █ ███  ███      
       ███   █ █     █  ██ +         █   █  █  █   █            █  █       ██   
  █  █   █      █ █    █ █ +     █    █ █     █  █    █   ██  █   █    █        
█  ███   █  █     █   ██ █ ++  █ █ █ +++  █ █ █  █    █ ██  █ ██      █         
█      ██  ███     █   █   █+++ █ █+++█+█   █  ██  ███   █     ██      ███   █  
 █       █      █  █         █+ ███+█ █+ ██ ██ █   █     █ █   ██ ███      ██   
  █  █        ██  ███   █ █  █++++++█ █+++++ ██G+█ ███            █        █    
██       █ ██    █ ██  ██   █       ██ █ █ +███ ++ █      █   █               █ 
██ █       █     █   █  ██ █ █   █  █      ++ █  +       █    ██     ██     ███ 
  ██ █    █      █ █       █ █████   █ █   █+ █  +  ██    ██         █  █    ██ 
    █      █ █      █       ████  █     █ █ +████+ █    █   ██ ███            █ 
██        █         █   █  █   █ █ █  █ █   ++++++  █  █           █  █         
█ █    █  █   ██       ██          █  █ ██     █ █           ███ █     █        
    █ █   ███         ███ █  █  █  █ █          █ █  ██       █   █ █████  ██ ██
██ █  █   ███ ██   █      ██    ██          █   █   █     █    █  █        █    
 ███ █ █ █ ██   ██  █   █   ██         █ █         █    █             ███  █ █  
█   █    ██  █   █ █  █       █   █ █   █ ██  █   █         █ █  █ ██         ██
 █     █ █  █     █       ██ ██  █ █    █   ████ █ ███       ███   █       █ █  
█       █████     ███ █  █ █ █ ███           █  █ █  █    █ █         ██ █     █
█       ██  █     █      █     █     █  ███        █   ██  █   █    █  █ ███  █ 
 █   █ █ █  ██ █        █ █ █  █          █      ██  █ ██    █  █  █ █   █      
█          █     ██  █ █ ███ █ ███   █  ███   █ █  ██ █ █           █  █  █    █
   ███     █    █ █ █   ██    ██      ██ █   █           █████  █  ██           
█ █  █ █   █  █   ██  ██    █    █ █  █    █ ████  █       █ █   █   ████   ██  
   █      █    ████  ███  █     █  ██  ██ █   █      █ █ █  █        █    ██    
   █      █    █         █ █    █     █  █ █  █ █     █      █  █ █   █   █   ██
  █      █      █ █ █   ██  ███      ██    █     █       ██  █  █  ██ █    ██  █
 █ █  █     █  █ █  █         █   █ █ ██   █       █ ████     ██    █ █   █ ████
██ █  █   █  █    █     █         █ █    █  ████ █       █ █    █             █ 
   █   ██       █        █ ██ ██  █ ██    ██ █  ██    ██ █ █    ███  ███  █     
█ █ █ ██   █  █  █  ██ █ █    █      ███   ██ █    █      ██ █ █   ██ █   ██    
██  █   █ █   ██    ██ █  ██ █ ████ █  ██  █    █ █           █  ██  ███  █    █
  █     █   █   █    █     █    ██      █ ██    ██  ████       █  █    █       █
       █     █      █ █   ███  █ █ █  █  ███ █ █ █      █ █    █ █   █    ██ █ █
██   █  █  █  █  █    █        █             █ █  █      ██   ██        █       
    █ ██     ██ █  █ █   █ █ █   ██          █   █            █   █        █ █  
██ ██   █ █  █ █     █     ███    █    ███       █ █                ██ █ █  █   
  ██  █ █  █ ███  ██  ██ ██ █     █    █  █      ███  █  █ █ ████   ██   █  ███ 
█ ██ ██         █            █   █ █      ██       ███ █   █     █ █ ██ █    █  
██    █       ██      ██ █        ███   ██  █  █       █   █   █       ██ ███   
███     ██  █ █  ██ █   █ █       ██   █ █  █    █ ██                  █ █   █ █
   █     █   █ ██ ███    ██  ██   ██   █   █ ██     ███  █ ██ █  █           █  
 █ ██      ██ ██ █  █  █   █         ██ ██  █  ██  █   █   █    █        █   █ █
  █ █ █     ███   █      ██ █ ██       ███ █    █   ██    █     ███    █        
       ██          █  █  █   █ █       █ █ █   ██   █   █        █ ███        █ 
